F 139,99,58
C 171,154,137

NO textures/hell1_600.xpm
SO textures/matrix2.xpm
WE textures/shrub.xpm
EA textures/fractal.xpm

11111111111111111111111111111111111111111111111111111111111111
10000000000000000000000000000000000000000000000000000000000001
10111111111111111111111111111111111111111111111111111111111001
10100000000000000000000000000000000000000000000000000000001001
10101111111111111111111111111111111111111111111111111111101001
10100000000000000000000000000000000000000000000000000000001001
10101111111111111111111111111111111111111111111111111111101001
10100000000000000000000000000000000000000000000000000000001001
10101111111011111111111111111111111111111111111111111111101001
10100000001010000000000000000000000000000000000000000000001001
10111111101010111111111111111111111111111111111111111111101001
10000000101010100000000000000000000000000000000000000000001001
10111110101010101111111111111111111111111111111111111111111001
10100000101010101000000000000000000000000000000000000000001001
10101111111111111111111111111111111111111111111111111111101001
10100000000000000000000000000000000000000000000000000000101001
10111111111111111111111111111111111111111111111111111110101001
10000000000000000000000000000000000000000000000000000101001001
11111111111111111111111111111111111111111111111111110101001001
10000000000000000000000000000000000000000000000000101001001001
10111111111111111111111111111111111111111111110101010101001001
10100000000000000000000000000000000000000000010101010101001001
10111111111111111111111111111111111111111101010101010101001001
10000000000000000000000000000000000000001010101010101010101001
11111111111111111111111111111111111110101010101010101010101001
10000000000000000000000000000000001010101010101010101010101001
10111111111111111111111111111101010101010101010101010101011001
10100000000000000000000000001010101010101010101010101010000001
10101111111111111111111101010101010101010101010101010101111101
10100000000000000000001010101010101010101010101010101000000001
10111111111111111101010101010101010101010101010101010101211111
10000000000000001010101010101010101010101010101010101010000001
11111111111101010101010101010101010101010101010101010101011101
10000000001010101010101010101010101010101010101010101010001001
10111110101010101010101010101010101010101010101010101011101001
10100000101010101010101010101010101010101010101010101000001001
10111111111110101010101010101010101010101010101010101111111001
10000000000000101010101010101010101010101010101010000000000001
11111111111111101010101010101010101010101010101011111111111101
10000000000000001010101010101010101010101010101000000000000001
10111111111111111101010101010101010101010101011111111111111001
10100000000000000000001010101010101010101010000000000000001001
10111111111111111111111110101010101010111111111111111111101001
10000000000000000000000000101010101010000000000000000000001001
11111111111111111111111111101010101011111111111111111111111001
10000000000000000000000000001010101000000000000W00000000000001
11111111111111111111111111111111111111111111111111111111111111
