NO textures/houses5.xpm
SO textures/houses2.xpm
WE textures/houses7.xpm
EA textures/houses4.xpm
F 80,80,60
C 140,140,140
        1111111111111111111111111
        1020000000110000000000001
        1011000001110000000000001
        1001000000200000000000001
111111111011000001110000000000001
1000000000110000N1112111111111111
11110111111111011100000020001
11112111111111011101010010001
11000000110101211100000010001
10000000000000001100000010001
10000000000000000001010010001
1100000111010101111101111000111
11110111 1110101 101111020001
11111111 1111111 111111111111
