NO textures/hell1_600.xpm
SO textures/matrix2.xpm
WE textures/shrub.xpm
EA textures/fractal.xpm
F 120,100,0
C 22,30,200
1111111111111111111111111
1E00000000011000000000001
1000000000011000000000001
1110000000020000000000001
1110000000010000000000001
1000000000010000000000001
1000000000010000000000001
1111111111111111111111111
