NO textures/houses5.xpm
SO textures/houses2.xpm
WE textures/houses7.xpm
EA textures/houses4.xpm
F 80,80,60
C 140,140,140
1111111111111111111111111
1E00000000000000000000001
1111111111111111111111111
