NO textures/houses5.xpm
SO textures/houses2.xpm
WE textures/houses7.xpm
EA textures/houses4.xpm
F 80,80,60
C 140,140,140

1111111111111111111111111111111111111111111111111111111111111111111111111111111111111111111111
10000000000000000000000000000000000000000000000000000000000000000000000000000000000000000000001
10111111111111111111111111111111111111111111111111111111111111111111111111111111111111111111001
10100000000000000000000000000000000000000000000000000000000000000000000000000000000000000001111
10101111111111111111111111111111111111111111111111111111111111111111111111111111111111101001
10100000000000000000000000000000000000000000000000000000000000000000000000000000000000001001
10101111111111111111111111111111111111111111111111111111111111111111111111111111111111101001
10100000000000000000000000000000000000000000000000000000000000000000000000000000000000001001
10101111111011111111111111111111111111111111111111111111111111111111111111111111111111101001
10100000001010000000000000000000000000000000000000000000000000000000000000000000000000001001
10111111101010111111111111111111111111111111111111111111111111111111111111111111111111111001
10000000101010100000000000000000000000000000000000000000000000000000000000000000000000001001
10111110101010101111111111111111111111111111111111111111111111111111111111111111111111111001
10100000101010101000000000000000000000000000000000000000000000000000000000000000000000001001
10101111111211111111111111111111111111111111111111111111111111111111111111111111111111101001
10100000000000000000000000000000000000000000000000000000000000000000000000000000000000101001
10111111111111111111111111111111111111111111111111111111111111111111111111111111111110101001
10000000000000000000000000000000000000000000000000000000000000000000000000000000000000101001
11111111111111111111111111111111111111111111111111111111111111111111111111111111111111101001
10000000000000000000000000000000000000000000000000000000000000000000000000000000000000101001
10111111111111111111111111111111111111111111111111111111111111111111111111111111111110101001
10100000000000000000000000000000000000000000000000000000000000000000000000000000000001001001
10101111111111111111111111111111111111111111111111111111111111111111111111111111111111001001
10100000000000000000000000000000000000000000000000000000000000000000000000000000000000101001
10101111111111111111111111111111111111111111111111111111111111111111111111111111111110101001
10000000000000000000000000000000000000000000000000000000000000000000000000000000000010101001
11111111111111111111111111111111111111111111111111111111111111111111111111111111111111111101
10000000000000000000000000000000000000000000000000000000000000000000000000000000000000000001
10111111111111111111111111111111111111111111111111111111111111111111111111111111111111111101
10100000000000000000000000000000000000000000000000000000000000000000000000000000000000001001
10101111111111111111111111111111111111111111111111111111111111111111111111111111111111101001
10100000000000000000000000000000000000000000000000000000000000000000000000000000000000201001
10101111111011111111111111111111111111111111111111111111111111111111111111111111111111001001
10100000001010000000000000000000000000000000000000000000000000000000000000000000000001001001
10111111101010111111111111111111111111111111111111111111111111111111111111111111111101001001
10000000101010100000000000000000000000000000000000000000000000000000000000000000000011001001
11111110101010101111111111111111111111111111111111111111111111111111111111111111111101001001
10000000101010101000000000000000000000000000000000000000000000000000000000000000000001001001
10111110111110111111111111111111111111111111111111111111111111111111111111111111111101001001
10100000100000100000000000000000000000000000000000000000000000000000000000000000000001001001
10111111111111111111111111111111111111111111111111111111111111111111111111111111111111111001
10000000000000000000000000000000000000000000000000000000000000000000000000000000000000001001
11111111111111111111111111111111111111111111111111111111111111111111111111111111111111111101
10000000000000000000000000000000000000000000000000000000000000000000000000000000000000000101
10111111111111111111111111111111111111111111111111111111111111111111111111111111111111111101
10100000000000000000000000000000000000000000000000000000000000000000000000000000000000001001
10101111111111111111111111111111111111111111111111111111111111111111111111111111111111001001
10100000000000000000000000000000000000000000000000000000000000000000000000000000000000101001
10111111111111111111111111111111122222222222221111111111111111111111111111111111111111111001
100000000000000000000000000000000000000N0000000000000000000000000000000000000000000000000001
11111111111111111111111111111111111111111111111111111111111111111111111111111111111111111111
